NO pics/greystone.png
SO pics/bluestone.png
WE pics/redbrick.png
EA pics/wood.png

F  52,73,94
C  135,206,237

        1111111
        1000001
111111111000001111111111
100000000000000000000001
100000000000000000000001
100000000000000000000001
100000222220000202020001
100000200020000000000001
100000200020000202020001
100000200020000000000001
100000220220000202020001
100000000000000000000001
100000000000000000000001
100000000000000000000001
100000000000000000000001
100000000000W00000000001
100000000000000000000001
100000000000000000000001
12222222200000000N000001
120200002000000000000001
120000202000000000000001
120200002000000000000001
120222222000000000000001
120000000000000000000001
122222222000000000000001
111111111111111111111111
